## Cape Colony - Cabo da Boa Esperança ##

Cape Town - Cabo
Worcester - Areia Verhelma
Swettenham - Vasconcelos
Mossel Bay - Aguada de São Brás
Beaufort - Belo Forte d'Oeste	

## Eastern Cape - Cabo oriental ##

Port Elizabeth - Porto Isabel
Graaf Reinet - Viana-Mascarenhas
Bisho - Lisboa do Leste
Mathele - Serpa Norte
Umtata - São João do Sul

## Natal/Zululand - Lourenço ##

Thaba Bosiu - São Carlos Masseru
Durban - Porto Arrango
Emnambithi - Dona Silva
uMgungundlovu - Pedroburgo

## Basutoland/Orange -  ##

Lephoi - Fonteflores
Thaba Nchu - Bem-Vindo
Qwa-Qwa - Cidade da Coroa

## Tky-Gariep/Matabele/Transvaal -  ##

Makwasi - Lugopedra
Saan - Clérigo
Ga-Rankuwa - Pretória
Ga-Riba - Nova Ermelo
Mbabane - Povo 	Matanço
Mosega - Cabeça do Elefante
Tohoyandu - Netobrote
Tsaneng - Vila de Palabora

## Northern Cape - Cabo Norte ##

O'okiep - Pedro do Cão
Hantam - Calvínia
Emthanjeni - Vila Esperança
Griqualand - Povo Gríquas
Dithakong - Olhos-d'Água

## Namaqualand - ##

Ezorongondo - Golfo de Santa Marija
Nomabeb - Angra Pequena
Nu-gouses - Pântano Negro
Aixe-Aibes - Víbora

## Hereroland - ##

Otjozondjii - Gancho do Vento
Otjivanda - Grão-Manancial
Otjomuise - Rincão Oscuro
Epako - Avançada
Luhonono - Franja de Caprivi

## Bechuanaland - ##

Tsabong - Valecano
Gaborone - Gaberões
Mochudi - Miguel
Nokaneng - Sedítua
Serowe - Seroue